# difficulty: Easy
............
E######.....
...#..#####E
...#..#.....
...#######..
......#.....
..####R###..
..#....#....
..######....
............
............
............
