# difficulty: Normal
............
.....E......
..######....
..#..#..#...
..#..#..#...
.E####R####E
..#..#..#...
..#..#..#...
..######....
.....E......
............
............
