# difficulty: Hard
............
E#########..
.........#..
..########..
..#.....##..
..#.....##..
..#.....##..
..#...R###..
..#......#..
..########..
............
............
