..........
..E.......
..####....
......#...
..R...#X..
......#...
..####....
..E.......
..........
..........
